NO ./cobblestone.xpm

SO ./cobblestone.xpm

WE ./cobblestone.xpm

EA ./cobblestone.xpm

F 50,50,50

C 119,254,181

     1111111111
111111000000001
10000N000010011
100010000111111
1100000001
1111111111